XXXXXXXXXXXXXXX
X P         E X
X X X X X X X X
X  # #O# # #  X
X#X#X#X#X#X#X#X
X E # # # # E X
X#X#X#X#X#X#X#X
X  # # # # #  X
X X X X X X X X
X E         E X
XXXXXXXXXXXXXXX
